E 0 0 B 0 0 1 0 1 1
B 0 0 0 B 1 0 1 0 1
1 B 0 B 1 1 1 1 0 1
1 0 B 0 B 1 1 1 0 1
0 1 0 1 0 0 0 1 0 1
0 1 0 1 0 B 0 0 0 1
0 1 B 1 1 B 0 1 1 1
0 1 B 0 0 B 0 B 1 1
S 0 0 1 1 1 0 B 1 1
1 1 1 0 0 0 0 0 B 1